11111111111
1EC00000VP1
11111111111