11
1010V1010010000010100100000101
1010E1001010101000100100000101
1000C0000000000000000000000001
10100P001010101000100100000101
111111111111111111111111111111
111111111111111111111111111111