111111
1ECP01
10G001
100001
111111