1111111111111
1E000000000P1
1111111111111