111111111111111111111111111111
100000000000000000000000000001
1010V1010010000010100100000101
101VE1001010101000100100000101
1000C0000000000000000000000001
10100P001010101000100100000101
10000000000000000V00000000C001
111111111111111111111111111111
