111111111111111111111111111111
100000000000000000000000000001
101001010010000010100100000101
1010E1001010101000100100000101
100000000000000000000000000001
101001001010101000100100000101
1P000000000000000V000000000001
111111111111111111111111111111