111111
1ECP01
100001
100001
111111