1111111
1C0E001
1110101
10P0001
1111111