1111111
1C100E1
1100101
10P0001
1111111