111111111111111
111C0000C0000C1
111100C0000P001
1V0001111110001
1101111E1111111
1000C0000C000C1
111111111111111
111111111111111