1111111111111
1P100010000C1
101010001V001
100011E001111
1111111111111
