1111111111111
101VCCCCCCCC1
11CCC111111C1
1PC011ECCCCC1
1111111111111