111111111111111
1EPCCCCCCCCCCV1
111111111111111