111111111111111
1ECCCCCCCCCCCC1
1CCCCCCCCCCCCC1
1CCCCCCCCCCCCC1
1CCCCCCVCCCCCC1
1CCCCCCCCCCCCC1
1CCCCCCCCCCCCP1
111111111111111