111111111111111
1E0C0000C0000C1
100000C0000P001
111111111111111
100000000000001
10000000V000001
100000000000001
111111111111111